NO ./textures/cute1.png
SO ./textures/cute2.png
WE ./textures/cute3.png
EA   ./textures/cute3.png

F 108, 145, 29 
C 108, 215, 233  

1111111111111
1000000000001
1011110111101
1001000100001
1011011101101
1000000000001
1000010001001
1000000000N01
1111111111111
