






NO ./textures/wall3.png
SO ./textures/wall1.png
WE ./textures/wall2.png
EA ./textures/wall.png






F 200, 100, 0
C 225,30,12



1111111111111
1E00000000001
1110111111011
1000100000011
1011101111011
1000001000011
1111011011111
1000000000001
1111111111111