


NO ./textures/wall3.png
SO ./textures/wall1.png
WE ./textures/wall2.png
EA ./textures/wall.png

F 200, 100, 0
C 225,30,12


111111111111111
1E0000000100001
111011110110111
100010000010001
101110111110101
101000100000101
101011101110101
101000001010001
101111101011111
100000101000001
111101111111101
100000000000001
101111111111101
100000000000001
111111111111111